9 9 30
G B O P O G P O B
G I I I I I I I R
P I I I I I I I R
O I I I I I I I B
R I I I E I I I R
P I I I I I I I B
P I I I I I I I O
B I I I I I I I O
B G O G O B P B P