7 7 7
E E P O B E E
E P I I I O E
G I I I I I P
O I I I I I O
O I I I I I B
E B I I I G E
E E B B O E E