9 8 20
E E E E G E E E E
E E E B G B E E E
E E I B P G I E E
E I I I O I I I E
G I I I G I I I G
I I I I G I I I I
I I I I B I I I I
PH I I I GH I I I PH