G O P G B O
P G P O P G
B B O G O B
I I I I I I
I I I I I I
I I I I I I
I I I I I I
I I I I I I