7 9 10
E PV E O E GV E
E G E G E P E
E O P B P B E
E O P I B P E
I P O I B B I
I I P I G I I
I I I I I I I
I I I I I I I
E I I I I I E