7 7 22
E E I O B P B
G I I I B O B
P I I I I G O
B I I E I I G
G G I I I I I
G I G I I I O
O G B G I E E