5 5 30
B G O P O
O R B R P
O G O R O
B R B P P
B G O B O