5 5 8
B P O P B
P O B O G
G B G G P
G O B O P
B G O P O