7 7 10
E E P O P E E
E P B P O O E
G I I I I I P
O I I I I I O
O I I I I I B
E B I I I G E
E E B B O E E